*************
*   *   *   *
* * *** * ***
*G*      P  *
* ***  ** * *
* *       * *
* * ******* *
* *   *     *
* *** * *** *
*   * * * * *
* * * *   * *
* *     *   *
*************
