*********
*G      *
**  * ***
*   * * *
* **  * *
*       *
* ***** *
*  P    *
*********
