***********
*     *   *
***** * ***
*P    * * *
* ***** * *
*      G* *
* **  *** *
*   *     *
*** *** * *
*       * *
***********
