*******
* *   *
* * ***
* *   *
* * * *
*G   P*
*******
